18 18
101 151
000 000 000 011 000 011 080 011 000 000 000 000 000 000 000 000 000 000
000 000 000 011 000 000 000 010 000 000 000 000 011 000 000 000 000 000
000 000 000 011 000 000 000 000 000 002 000 000 000 000 000 000 010 000
000 000 000 010 000 000 002 000 010 010 000 000 001 000 000 000 000 000
000 000 042 000 010 000 010 010 000 000 000 010 000 011 000 000 000 000
000 000 000 000 000 000 000 010 000 000 010 010 010 010 010 000 000 000
000 000 000 000 000 000 000 000 000 000 000 000 000 000 000 000 000 000
010 000 000 000 000 000 000 000 010 000 000 000 000 000 000 000 000 000
000 000 010 000 000 010 000 000 000 000 000 000 000 000 000 000 000 000
010 000 000 010 000 000 000 000 000 000 000 000 000 000 000 010 000 000
010 000 000 000 000 010 000 000 000 000 000 000 000 000 000 010 000 000
010 000 000 000 000 000 000 000 000 000 000 000 000 000 000 010 000 000
010 000 000 000 000 000 000 000 000 000 000 000 000 000 000 010 000 000
010 000 000 000 000 000 000 000 010 000 000 000 000 000 000 010 000 000
010 010 000 000 000 040 000 000 010 000 000 000 000 000 041 010 000 000
010 010 010 010 010 010 010 010 010 010 010 010 010 010 010 010 000 000
000 010 000 010 000 010 000 010 000 010 000 010 000 010 000 010 000 010
000 010 000 010 000 010 000 010 000 010 000 010 000 010 000 010 000 010